8 9 
   ######
####?  !#
#  ooo  #
#?##?##?#
#   o   #
#  o?# ##
####   #
   #####