9 11
  #####
  #   # 
###o?O#####
#   ? o   #
# ##o## ! #
#   ? #####
### ? #
  #   #
  #####