7 7
  #####
  #   #
  # o o#
  # ??!#
  #  # #
#####  #
    ####